5 5
0 0 0 0 1
2 2 2 0 0
4 4 4 3 0
0 4 4 2 0
0 0 0 0 0