16 9
. . . . M . . . . . . M . . . .
. . . O M O . O O . O M O . . .
. . . O M . . . . . . M O . . .
. . . . . O . X . . O . . . . .
O O . . . O . X X . O . . . O O
. . . . . . . . . . . . . . . .
. . . M M O . . G . O M M . . .
. . . O M . . . G G . M O . . .
. . . . . . . . G G G G . . . .