10 9
0 4 4 3 0 2 0 0 0 0
0 4 0 0 0 4 2 0 0 0
0 4 1 0 2 4 0 0 0 0
0 4 0 2 0 4 0 2 0 0
0 2 0 0 2 4 4 0 0 0
0 0 2 0 0 2 4 0 0 0
0 0 0 0 0 0 3 1 0 0
0 0 0 2 0 2 0 0 0 0
0 0 0 0 0 0 0 0 0 0	