5 7
0 6 6 6 0 
0 5 5 5 0 
0 5 4 5 0 
0 0 4 0 0 
0 4 0 4 0 
0 0 1 0 0 
0 0 4 0 0 
