5 5 -1 -1
0 0 3 0 2 
0 0 3 0 0 
0 0 1 3 2 
0 5 5 0 0 
0 0 5 5 5 
