5 5 -1 -1
0 0 3 0 0 
0 0 3 0 5 
0 0 0 3 5 
0 0 0 0 1 
0 6 0 0 5 
