5 5 -1 -1
0 0 3 0 0 
5 0 3 0 0 
0 0 0 3 0 
0 0 0 0 0 
0 6 0 0 0 
