5 7 19 -1
2 0 0 0 2 
2 0 0 0 0 
2 3 0 3 0 
0 0 6 4 0 
0 0 0 4 2 
0 0 0 4 0 
1 0 0 4 0 
